{
     "id" : "op_center",
     "tileset" : "alpha",
     "layers" : [
         [ 852, 852, 852, 852, 852, 852, 852, 852, 852, 852, 852, 852, 852, 852, 852, 852, 852, 852,
           786, 786, 786, 786, 786, 786, 786, 786, 786, 786, 786, 786, 786, 786, 786, 786, 786, 786,
           786, 786, 786, 786, 786, 786, 786, 786, 786, 786, 786, 786, 786, 786, 786, 786, 786, 786,
           786, 402, 402, 402, 402, 402, 402, 402, 402, 402, 402, 402, 402, 402, 402, 402, 402, 786,
           786, 402, 402, 402, 402, 402, 402, 402, 402, 402, 402, 402, 402, 402, 402, 402, 402, 786,
           786, 402, 402, 786, 786, 786, 786, 786, 786, 786, 786, 786, 786, 786, 786, 402, 402, 786,
           786, 402, 402, 786, 786, 786, 786, 786, 786, 786, 786, 786, 786, 786, 786, 402, 402, 786,
           852, 0, 0, 852, 852, 852, 852, 852, 852, 852, 852, 852, 852, 852, 852, 0, 0, 852,
           786, 0, 0, 786, 786, 786, 786, 786, 786, 786, 786, 786, 786, 786, 786, 786, 786, 786,
           786, 786, 786, 786, 786, 786, 786, 786, 786, 786, 786, 786, 786, 786, 786, 786, 786, 786,
           786, 402, 402, 786, 786, 786, 786, 786, 786, 786, 786, 786, 786, 786, 786, 402, 402, 786,
           786, 402, 402, 786, 786, 786, 786, 786, 786, 786, 786, 786, 786, 786, 786, 402, 402, 786,
           786, 402, 402, 786, 786, 786, 786, 786, 786, 786, 786, 786, 786, 786, 786, 402, 402, 786,
           786, 402, 402, 402, 402, 402, 402, 402, 402, 402, 402, 402, 402, 402, 402, 402, 402, 786,
           786, 402, 402, 402, 402, 402, 402, 402, 402, 402, 402, 402, 402, 402, 402, 402, 402, 786,
           786, 786, 786, 786, 786, 786, 786, 786, 402, 402, 786, 786, 786, 786, 786, 786, 786, 786,
           786, 786, 786, 786, 786, 786, 786, 786, 402, 402, 786, 786, 786, 786, 786, 786, 786, 786,
           786, 786, 786, 786, 786, 786, 786, 786, 402, 402, 786, 786, 786, 786, 786, 786, 786, 786 ],
         [ 0, 0, 0, 0, 1154, 1155, 1154, 1155, 1154, 1155, 1153, 0, 0, 0, 0, 2372, 2305, 2306,
           916, 916, 916, 916, 1218, 1219, 1218, 1219, 1218, 1219, 1217, 916, 916, 916, 916, 916, 2369, 2370,
           0, 0, 0, 0, 0, 0, 982, 0, 0, 0, 0, 0, 982, 0, 0, 0, 0, 0,
           1043, 0, 1090, 1091, 1091, 1091, 1091, 1091, 1091, 1091, 1091, 1091, 1091, 1091, 1091, 1092, 0, 1043,
           0, 0, 1108, 0, 0, 1108, 0, 0, 1108, 0, 0, 1108, 0, 0, 1108, 0, 0, 0,
           0, 0, 0, 0, 0, 0, 0, 0, 0, 0, 0, 0, 0, 0, 0, 0, 0, 0,
           984, 985, 986, 987, 0, 0, 0, 0, 0, 0, 0, 0, 0, 0, 984, 985, 986, 987,
           1048, 1049, 1050, 1051, 1025, 1025, 0, 0, 0, 0, 0, 1153, 1153, 1025, 1048, 1049, 1050, 1051,
           916, 1113, 1114, 916, 1089, 1089, 916, 916, 916, 916, 916, 1217, 1217, 1089, 916, 1113, 1114, 916,
           1176, 1177, 1178, 1179, 0, 786, 2003, 2004, 0, 0, 0, 0, 0, 0, 1176, 1177, 1178, 1179,
           0, 0, 0, 0, 786, 786, 2067, 2068, 786, 982, 0, 0, 0, 0, 0, 0, 0, 0,
           0, 0, 0, 0, 0, 786, 786, 786, 1090, 1091, 1092, 1492, 0, 0, 0, 0, 0, 0,
           0, 0, 0, 0, 0, 0, 0, 0, 0, 0, 0, 0, 0, 0, 0, 0, 0, 0,
           0, 0, 0, 0, 0, 0, 0, 0, 1409, 1410, 0, 0, 0, 0, 0, 0, 0, 0,
           1808, 0, 2119, 2121, 0, 0, 0, 0, 1473, 1474, 0, 0, 0, 0, 2119, 2121, 0, 1808,
           0, 1108, 2247, 2249, 1108, 0, 0, 0, 0, 0, 0, 0, 0, 1108, 2247, 2249, 1108, 0,
           0, 0, 0, 0, 0, 0, 0, 0, 0, 0, 0, 0, 0, 0, 0, 0, 0, 0,
           1493, 0, 0, 0, 0, 0, 0, 0, 0, 0, 0, 0, 0, 0, 0, 0, 0, 1493 ],
         [ 0, 0, 0, 0, 0, 0, 0, 0, 0, 0, 0, 0, 0, 0, 0, 0, 0, 0,
           0, 0, 0, 0, 0, 0, 0, 0, 0, 0, 0, 0, 0, 0, 0, 0, 0, 0,
           979, 0, 1026, 1027, 1027, 1027, 1027, 1027, 1027, 1027, 1027, 1027, 1027, 1027, 1027, 1028, 0, 979,
           0, 0, 0, 0, 0, 0, 0, 0, 0, 0, 0, 0, 0, 0, 0, 0, 0, 0,
           0, 0, 0, 0, 0, 0, 0, 0, 0, 0, 0, 0, 0, 0, 0, 0, 0, 0,
           0, 0, 0, 0, 0, 0, 0, 0, 0, 0, 0, 0, 0, 0, 0, 0, 0, 0,
           0, 0, 0, 0, 0, 0, 0, 0, 0, 0, 0, 0, 0, 0, 0, 0, 0, 0,
           1048, 0, 0, 1051, 0, 0, 0, 0, 0, 0, 0, 0, 0, 0, 1048, 0, 0, 1051,
           1112, 0, 0, 1115, 0, 0, 0, 0, 0, 0, 0, 0, 0, 0, 1112, 0, 0, 1115,
           0, 0, 0, 0, 0, 0, 0, 0, 0, 0, 0, 0, 0, 0, 0, 0, 0, 0,
           0, 0, 0, 0, 0, 0, 0, 0, 1026, 1027, 1028, 1428, 0, 0, 0, 0, 0, 0,
           0, 0, 0, 0, 0, 0, 0, 0, 0, 0, 0, 0, 0, 0, 0, 0, 0, 0,
           0, 0, 0, 0, 0, 0, 0, 0, 0, 0, 0, 0, 0, 0, 0, 0, 0, 0,
           1744, 0, 0, 0, 0, 0, 0, 0, 0, 0, 0, 0, 0, 0, 0, 0, 0, 1744,
           0, 0, 0, 0, 0, 0, 0, 0, 0, 0, 0, 0, 0, 0, 0, 0, 0, 0,
           0, 0, 0, 0, 0, 0, 0, 0, 0, 0, 0, 0, 0, 0, 0, 0, 0, 0,
           1429, 0, 0, 0, 0, 0, 0, 0, 0, 0, 0, 0, 0, 0, 0, 0, 0, 1429,
           0, 0, 0, 0, 0, 0, 0, 0, 2057, 2058, 0, 0, 0, 0, 0, 0, 0, 0 ]
     ],
     "size" : [ 18, 18 ],
     "indoor" : true,
     "music" : "Start",
     "events" : [
         {
             "type" : "TalkingCharacter",
             "textures" : "inferm",
             "position" : [ 9, 10 ],
             "dialog" : ["inferm.dialog"],
             "facing" : 0,
             "passable" : false
         },
         {
             "type" : "Dialog",
             "textures" : "alpha",
             "position" : [ 9, 11 ],
             "dialog" : ["inferm.dialog"],
             "side" : 1
         },
         {
             "type" : "TP",
             "textures" : "alpha",
             "trigger" : 3,
             "position" : [ 9, 17 ],
             "tp" : {
                 "position" : [ 15, 13 ],
                 "map" : "mysteriou_city",
                 "side" : 0
             },
             "side" : 2
         },
         {
             "type" : "TP",
             "textures" : "alpha",
             "trigger" : 3,
             "position" : [ 8, 17 ],
             "tp" : {
                 "position" : [ 15, 13 ],
                 "map" : "mysteriou_city",
                 "side" : 0
             },
             "side" : 2
         }
     ]
 }