{
     "id" : "MysteriouCity",
     "layers" : [
         [ 68, 68, 68, 68, 68, 68, 68, 68, 68, 68, 68, 68, 68, 68, 68, 68, 68, 69, 1, 1, 1, 2, 67, 68, 68, 68,
           68, 68, 68, 68, 68, 68, 68, 68, 68,
           68, 68, 68, 68, 68, 68, 68, 68, 68, 68, 68, 68, 68, 68, 68, 68, 68, 69, 65, 1, 65, 66, 67, 68, 68,
           68, 68, 68, 68, 68, 68, 68, 68, 68, 68,
           68, 68, 68, 68, 68, 68, 68, 68, 68, 68, 68, 68, 68, 68, 68, 68, 68, 69, 65, 65, 65, 66, 67, 68, 68,
           68, 68, 68, 68, 68, 68, 68, 68, 68, 68,
           68, 68, 68, 68, 68, 68, 68, 68, 68, 68, 68, 68, 68, 68, 68, 68, 68, 69, 1, 2, 1, 2, 67, 68, 68, 68,
           68, 68, 68, 68, 68, 68, 68, 68, 68,
           68, 68, 68, 68, 68, 68, 68, 68, 68, 68, 68, 68, 68, 68, 68, 68, 68, 69, 65, 66, 1, 2, 67, 68, 68,
           68, 68, 68, 68, 68, 68, 68, 68, 68, 68,
           68, 68, 68, 68, 68, 68, 68, 68, 68, 68, 68, 68, 68, 68, 68, 68, 68, 69, 1, 2, 65, 66, 67, 68, 68,
           68, 68, 68, 68, 68, 68, 68, 68, 68, 68,
           68, 68, 68, 68, 68, 68, 68, 68, 68, 68, 68, 68, 68, 68, 68, 68, 68, 69, 65, 66, 1, 2, 67, 68, 68,
           68, 68, 68, 68, 68, 68, 68, 68, 68, 68,
           68, 68, 68, 68, 68, 68, 68, 73, 132, 132, 132, 132, 132, 132, 132, 132, 132, 133, 66, 66, 65, 66,
           67, 68, 68, 68, 68, 68, 68, 68, 68, 68, 68, 68, 68,
           68, 68, 68, 68, 68, 68, 68, 69, 1, 2, 2, 2, 2, 2, 2, 1, 2, 2, 1, 2, 1, 2, 67, 68, 68, 68, 68, 68,
           68, 68, 68, 68, 68, 68, 68,
           68, 68, 68, 68, 68, 68, 68, 69, 1, 2, 1, 2, 2, 66, 66, 2, 2, 66, 1, 2, 1, 2, 67, 68, 68, 68, 68, 68,
           68, 68, 68, 68, 68, 68, 68,
           68, 68, 68, 68, 68, 68, 68, 69, 1, 2, 1, 2, 66, 2, 66, 66, 66, 2, 1, 2, 1, 2, 131, 132, 132, 132,
           132, 72, 68, 68, 68, 68, 68, 68, 68,
           68, 68, 68, 68, 68, 68, 68, 69, 1, 2, 1, 2, 66, 66, 2, 65, 66, 66, 65, 66, 65, 66, 1, 2, 65, 1, 2,
           67, 68, 68, 68, 68, 68, 68, 68,
           68, 68, 68, 68, 68, 68, 68, 69, 1, 2, 1, 2, 65, 66, 66, 2, 2, 2, 2, 2, 2, 2, 2, 2, 1, 2, 2, 67, 68,
           68, 68, 68, 68, 68, 68,
           68, 68, 68, 68, 68, 68, 68, 69, 1, 2, 1, 2, 1, 2, 2, 2, 2, 2, 2, 2, 2, 2, 66, 66, 1, 2, 66, 67, 68,
           68, 68, 68, 68, 68, 68,
           68, 68, 68, 68, 68, 68, 68, 69, 1, 2, 1, 2, 1, 2, 1, 2, 2, 2, 2, 2, 66, 66, 65, 66, 1, 1, 2, 67, 68,
           68, 68, 68, 68, 68, 68,
           132, 132, 132, 132, 132, 132, 132, 133, 1, 2, 1, 2, 1, 2, 1, 2, 1, 2, 2, 66, 65, 66, 65, 66, 1, 1,
           2, 67, 68, 68, 68, 68, 68, 68, 68,
           2, 2, 2, 2, 2, 2, 2, 2, 2, 2, 1, 2, 1, 2, 1, 1, 2, 2, 66, 66, 65, 66, 2, 66, 2, 1, 2, 67, 68, 68,
           68, 68, 68, 68, 68,
           66, 66, 66, 66, 66, 66, 66, 66, 66, 66, 1, 2, 1, 2, 1, 1, 2, 66, 66, 2, 2, 66, 66, 65, 66, 1, 2, 67,
           68, 68, 68, 68, 68, 68, 68,
           1, 2, 2, 2, 2, 2, 2, 2, 2, 2, 1, 2, 1, 2, 1, 1, 1, 2, 65, 66, 66, 2, 66, 65, 66, 1, 2, 67, 68, 68,
           68, 68, 68, 68, 68,
           65, 66, 66, 66, 66, 66, 66, 66, 1, 2, 1, 2, 1, 2, 2, 2, 2, 2, 2, 2, 2, 66, 66, 65, 66, 1, 2, 67, 68,
           68, 68, 68, 68, 68, 68,
           4, 4, 4, 4, 4, 4, 4, 5, 1, 2, 1, 2, 1, 2, 66, 66, 66, 66, 66, 66, 66, 66, 2, 2, 66, 1, 2, 67, 68,
           68, 68, 68, 68, 68, 68,
           68, 68, 68, 68, 68, 68, 68, 69, 1, 2, 1, 2, 1, 2, 1, 1, 1, 1, 1, 1, 65, 66, 66, 66, 2, 2, 2, 67, 68,
           68, 68, 68, 68, 68, 68,
           68, 68, 68, 68, 68, 68, 68, 69, 1, 2, 1, 1, 65, 66, 65, 65, 65, 65, 65, 65, 65, 65, 66, 65, 66, 2,
           66, 67, 68, 68, 68, 68, 68, 68, 68,
           68, 68, 68, 68, 68, 68, 68, 69, 1, 2, 65, 1, 1, 1, 1, 1, 1, 1, 1, 1, 1, 1, 1, 65, 66, 1, 2, 67, 68,
           68, 68, 68, 68, 68, 68,
           68, 68, 68, 68, 68, 68, 68, 69, 1, 2, 1, 65, 65, 65, 65, 65, 65, 65, 65, 65, 65, 65, 65, 66, 1, 2,
           2, 67, 68, 68, 68, 68, 68, 68, 68,
           68, 68, 68, 68, 68, 68, 68, 69, 1, 1, 65, 1, 1, 1, 1, 1, 1, 2, 2, 1, 1, 1, 1, 1, 65, 66, 2, 67, 68,
           68, 68, 68, 68, 68, 68,
           68, 68, 68, 68, 68, 68, 68, 69, 65, 65, 65, 65, 65, 65, 65, 65, 1, 1, 2, 65, 65, 65, 65, 65, 65, 65,
           66, 67, 68, 68, 68, 68, 68, 68, 68,
           68, 68, 68, 68, 68, 68, 68, 9, 4, 4, 4, 4, 4, 4, 4, 5, 1, 65, 66, 3, 4, 4, 4, 4, 4, 4, 4, 8, 68, 68,
           68, 68, 68, 68, 68,
           68, 68, 68, 68, 68, 68, 68, 68, 68, 68, 68, 68, 68, 68, 68, 69, 65, 65, 66, 67, 68, 68, 68, 68, 68,
           68, 68, 68, 68, 68, 68, 68, 68, 68, 68,
           68, 68, 68, 68, 68, 68, 68, 68, 68, 68, 68, 68, 68, 68, 68, 69, 65, 66, 2, 67, 68, 68, 68, 68, 68,
           68, 68, 68, 68, 68, 68, 68, 0, 68, 68,
           68, 68, 68, 68, 68, 68, 68, 68, 68, 68, 68, 68, 68, 68, 68, 69, 65, 66, 2, 67, 68, 68, 68, 68, 68,
           68, 0, 68, 68, 68, 68, 68, 68, 68, 68,
           68, 68, 68, 68, 68, 68, 68, 68, 68, 68, 68, 68, 68, 68, 68, 69, 65, 66, 2, 67, 68, 68, 68, 68, 68,
           68, 68, 68, 68, 68, 68, 68, 68, 68, 68,
           68, 68, 68, 68, 68, 68, 68, 68, 68, 68, 68, 68, 68, 68, 68, 69, 65, 66, 2, 67, 68, 68, 68, 68, 68,
           68, 68, 68, 68, 68, 68, 68, 68, 68, 68,
           68, 68, 68, 68, 68, 68, 68, 68, 68, 68, 68, 68, 68, 68, 68, 69, 65, 66, 2, 67, 68, 68, 68, 68, 68,
           68, 68, 68, 68, 68, 68, 68, 68, 68, 68,
           68, 68, 68, 68, 68, 68, 68, 68, 68, 68, 68, 68, 68, 68, 68, 69, 65, 66, 2, 67, 68, 68, 68, 68, 68,
           68, 68, 68, 68, 68, 68, 68, 68, 68, 68 ],
         [ 0, 0, 0, 0, 0, 0, 0, 0, 0, 0, 0, 0, 0, 0, 0, 0, 0, 0, 284, 285, 0, 285, 0, 0, 0, 0, 0, 0, 0, 0, 0,
           0, 0, 0, 0,
           0, 0, 0, 0, 0, 0, 0, 0, 0, 0, 0, 0, 0, 0, 0, 0, 0, 0, 284, 285, 0, 349, 0, 0, 0, 0, 0, 0, 0, 0, 0,
           0, 0, 0, 0,
           0, 0, 0, 0, 0, 0, 0, 0, 0, 0, 0, 0, 0, 0, 0, 0, 0, 0, 284, 285, 0, 285, 0, 0, 0, 0, 0, 0, 0, 0, 0,
           0, 0, 0, 0,
           0, 0, 0, 0, 0, 0, 0, 0, 0, 0, 0, 0, 0, 0, 0, 0, 0, 0, 284, 349, 0, 285, 0, 0, 0, 0, 0, 1930, 0, 0,
           0, 0, 0, 0, 0,
           0, 0, 0, 0, 0, 0, 0, 0, 0, 0, 0, 0, 0, 0, 0, 0, 0, 0, 284, 285, 0, 349, 0, 0, 0, 0, 0, 1994, 0, 0,
           0, 0, 0, 0, 0,
           0, 0, 0, 0, 0, 0, 0, 0, 0, 0, 0, 0, 0, 0, 0, 0, 0, 0, 284, 285, 0, 285, 0, 0, 0, 0, 0, 1930, 0, 0,
           0, 0, 0, 0, 0,
           0, 0, 0, 0, 0, 0, 0, 0, 0, 0, 0, 0, 0, 0, 0, 0, 0, 0, 284, 285, 0, 285, 0, 0, 0, 0, 0, 1994, 0, 0,
           0, 0, 0, 0, 0,
           0, 0, 0, 0, 0, 0, 0, 0, 0, 0, 0, 0, 0, 0, 0, 0, 0, 0, 348, 349, 0, 349, 0, 0, 0, 0, 0, 1930, 0, 0,
           0, 0, 0, 0, 0,
           0, 0, 0, 0, 0, 0, 0, 0, 0, 0, 0, 0, 0, 0, 0, 0, 0, 0, 0, 0, 0, 0, 0, 0, 0, 0, 0, 1994, 0, 0, 0, 0,
           0, 0, 0,
           0, 0, 0, 0, 0, 0, 0, 0, 0, 0, 0, 0, 0, 2766, 2767, 2768, 2769, 2770, 0, 0, 0, 1223, 0, 0, 0, 0, 0,
           0, 0, 0, 0, 0, 0, 0, 0,
           0, 0, 0, 0, 0, 0, 0, 0, 0, 0, 0, 0, 0, 2830, 2831, 2832, 2833, 2834, 0, 0, 0, 0, 0, 0, 0, 220, 0, 0,
           0, 0, 0, 0, 0, 0, 0,
           0, 0, 0, 0, 0, 0, 0, 0, 0, 0, 0, 0, 0, 2894, 2895, 2896, 2897, 2898, 0, 0, 0, 0, 0, 284, 285, 284,
           285, 0, 0, 0, 0, 0, 0, 0, 0,
           0, 0, 0, 0, 0, 0, 0, 0, 0, 0, 0, 0, 0, 2958, 2959, 2960, 2961, 2962, 0, 0, 0, 0, 0, 348, 349, 348,
           349, 0, 0, 0, 0, 0, 0, 0, 0,
           0, 0, 0, 0, 0, 0, 0, 0, 0, 0, 540, 0, 0, 0, 0, 0, 0, 0, 0, 0, 0, 0, 0, 0, 0, 0, 0, 0, 0, 0, 0, 0, 0,
           0, 0,
           0, 0, 0, 0, 0, 0, 0, 0, 0, 0, 0, 0, 0, 0, 0, 0, 0, 0, 0, 0, 0, 0, 0, 0, 0, 0, 1223, 0, 0, 0, 0, 0,
           0, 0, 0,
           0, 0, 0, 0, 0, 0, 0, 0, 0, 0, 0, 0, 0, 0, 540, 0, 0, 0, 0, 0, 0, 0, 0, 0, 0, 0, 0, 0, 0, 0, 0, 0, 0,
           0, 0,
           540, 540, 540, 540, 540, 540, 540, 540, 0, 0, 0, 0, 0, 0, 0, 0, 0, 0, 0, 0, 0, 0, 0, 0, 0, 0, 0, 0,
           0, 0, 0, 0, 0, 0, 0,
           540, 540, 540, 540, 540, 540, 540, 540, 0, 0, 0, 0, 0, 0, 1867, 1868, 1869, 1870, 1871, 0, 0, 0, 0,
           0, 0, 0, 0, 0, 0, 0, 0, 0, 0, 0, 0,
           540, 540, 540, 540, 540, 540, 540, 540, 0, 0, 0, 0, 0, 0, 1931, 1932, 1933, 1934, 1935, 0, 0, 0, 0,
           0, 0, 0, 0, 0, 0, 0, 0, 0, 0, 0, 0,
           2129, 2129, 2129, 2129, 2129, 2129, 2129, 2132, 0, 0, 540, 0, 0, 1223, 1995, 1996, 1997, 1998, 1999,
           0, 1223, 0, 0, 0, 0, 0, 0, 0, 0, 0, 0, 0, 0, 0, 0,
           0, 0, 0, 0, 0, 0, 0, 0, 0, 0, 0, 0, 0, 0, 0, 0, 0, 0, 0, 0, 0, 0, 0, 0, 0, 0, 0, 0, 0, 0, 0, 0, 0,
           0, 0,
           0, 0, 0, 0, 0, 0, 0, 0, 0, 0, 0, 0, 0, 0, 0, 0, 0, 0, 0, 0, 0, 0, 0, 0, 0, 0, 0, 0, 0, 0, 0, 0, 0,
           0, 0,
           0, 0, 0, 0, 0, 0, 0, 0, 0, 0, 1601, 1602, 1603, 1604, 1601, 1602, 1603, 1604, 0, 0, 0, 0, 1862,
           1863, 1864, 1865, 1866, 0, 0, 0, 0, 0, 0, 0, 0,
           0, 0, 0, 0, 0, 0, 0, 0, 0, 0, 1665, 1666, 1667, 1668, 1665, 1666, 1667, 1668, 0, 0, 540, 0, 1926,
           1927, 1928, 1929, 1930, 0, 0, 0, 0, 0, 0, 0, 0,
           0, 0, 0, 0, 0, 0, 0, 0, 0, 0, 1729, 1730, 1731, 1732, 1729, 1730, 1731, 1732, 0, 0, 0, 0, 1990,
           1991, 1992, 1993, 1994, 0, 0, 0, 0, 0, 0, 0, 0,
           0, 0, 0, 0, 0, 0, 0, 0, 0, 0, 0, 0, 0, 0, 0, 0, 0, 0, 0, 0, 0, 0, 0, 0, 0, 0, 0, 0, 0, 0, 0, 0, 0,
           0, 0,
           0, 0, 0, 0, 0, 0, 0, 0, 0, 0, 0, 0, 0, 0, 0, 0, 0, 0, 0, 0, 0, 0, 0, 0, 0, 0, 0, 0, 0, 0, 0, 0, 0,
           0, 0,
           0, 0, 0, 0, 0, 0, 0, 0, 0, 0, 0, 0, 0, 0, 0, 0, 540, 540, 540, 0, 0, 0, 0, 0, 0, 0, 0, 0, 0, 0, 0,
           0, 0, 0, 0,
           0, 0, 0, 0, 0, 0, 0, 0, 0, 0, 0, 0, 0, 0, 0, 0, 540, 540, 540, 0, 0, 0, 0, 0, 0, 0, 0, 0, 0, 0, 0,
           0, 0, 0, 0,
           0, 0, 0, 0, 0, 0, 0, 0, 0, 0, 0, 0, 0, 0, 0, 0, 540, 540, 540, 0, 0, 0, 0, 0, 0, 0, 0, 0, 0, 0, 0,
           0, 0, 0, 0,
           0, 0, 0, 0, 0, 0, 0, 0, 0, 0, 0, 0, 0, 0, 0, 0, 540, 540, 540, 0, 0, 0, 0, 0, 0, 0, 0, 0, 0, 0, 0,
           0, 0, 0, 0,
           0, 0, 0, 0, 0, 0, 0, 0, 0, 0, 0, 0, 0, 0, 0, 0, 540, 540, 540, 0, 0, 0, 0, 0, 0, 0, 0, 0, 0, 0, 0,
           0, 0, 0, 0,
           0, 0, 0, 0, 0, 0, 0, 0, 0, 0, 0, 0, 0, 0, 0, 0, 540, 540, 540, 0, 0, 0, 0, 0, 0, 0, 0, 0, 0, 0, 0,
           0, 0, 0, 0,
           0, 0, 0, 0, 0, 0, 0, 0, 0, 0, 0, 0, 0, 0, 0, 0, 540, 540, 540, 0, 0, 0, 0, 0, 0, 0, 0, 0, 0, 0, 0,
           0, 0, 0, 0,
           0, 0, 0, 0, 0, 0, 0, 0, 0, 0, 0, 0, 0, 0, 0, 0, 540, 540, 540, 0, 0, 0, 0, 0, 0, 0, 0, 0, 0, 0, 0,
           0, 0, 0, 0 ],
         [ 0, 0, 0, 0, 0, 0, 0, 0, 0, 0, 0, 0, 0, 0, 0, 0, 0, 0, 0, 0, 0, 0, 0, 0, 0, 0, 0, 0, 0, 0, 0, 0, 0,
           0, 0,
           0, 0, 0, 0, 0, 0, 0, 0, 0, 0, 0, 0, 0, 0, 0, 0, 0, 0, 0, 0, 0, 0, 0, 1798, 1799, 1800, 1801, 1802,
           0, 0, 0, 0, 0, 0, 0,
           0, 0, 0, 0, 0, 0, 0, 0, 0, 0, 0, 0, 0, 0, 0, 0, 0, 0, 0, 0, 0, 0, 0, 1862, 1863, 1864, 1865, 1866,
           0, 0, 0, 0, 0, 0, 0,
           0, 0, 0, 0, 0, 0, 0, 0, 0, 0, 0, 0, 0, 0, 0, 0, 0, 0, 0, 0, 0, 0, 0, 1926, 1929, 1929, 1929, 1930,
           0, 0, 0, 0, 0, 0, 0,
           0, 0, 0, 0, 0, 0, 0, 0, 0, 0, 0, 0, 0, 0, 0, 0, 0, 0, 0, 0, 0, 0, 0, 1990, 1993, 1993, 1993, 1994,
           0, 0, 0, 0, 0, 0, 0,
           0, 0, 0, 0, 0, 0, 0, 0, 0, 0, 0, 0, 0, 0, 0, 0, 0, 0, 0, 0, 0, 0, 0, 1926, 1929, 1929, 1929, 1930,
           0, 0, 0, 0, 0, 0, 0,
           0, 0, 0, 0, 0, 0, 0, 0, 0, 0, 0, 0, 0, 0, 0, 0, 0, 0, 0, 0, 0, 0, 0, 1990, 1993, 1993, 1993, 1994,
           0, 0, 0, 0, 0, 0, 0,
           0, 0, 0, 0, 0, 0, 0, 0, 0, 0, 0, 0, 0, 2638, 2639, 2640, 2641, 2642, 0, 0, 0, 0, 0, 1926, 1929,
           1929, 1929, 1930, 0, 0, 0, 0, 0, 0, 0,
           0, 0, 0, 0, 0, 0, 0, 0, 0, 0, 0, 0, 0, 2702, 2703, 2704, 2705, 2706, 0, 0, 0, 1159, 0, 1990, 1993,
           1993, 1993, 1994, 0, 0, 0, 0, 0, 0, 0,
           0, 0, 0, 0, 0, 0, 0, 0, 0, 0, 0, 0, 0, 0, 0, 0, 0, 0, 0, 0, 0, 0, 0, 0, 0, 0, 0, 0, 0, 0, 0, 0, 0,
           0, 0,
           0, 0, 0, 0, 0, 0, 0, 0, 0, 0, 0, 0, 0, 0, 0, 0, 0, 0, 0, 0, 0, 0, 0, 0, 0, 0, 0, 0, 0, 0, 0, 0, 0,
           0, 0,
           0, 0, 0, 0, 0, 0, 0, 0, 0, 0, 0, 0, 0, 0, 0, 0, 0, 0, 0, 0, 0, 0, 0, 0, 0, 0, 0, 0, 0, 0, 0, 0, 0,
           0, 0,
           0, 0, 0, 0, 0, 0, 0, 0, 0, 0, 0, 0, 0, 0, 0, 0, 0, 0, 0, 0, 0, 0, 0, 0, 0, 0, 0, 0, 0, 0, 0, 0, 0,
           0, 0,
           0, 0, 0, 0, 0, 0, 0, 0, 0, 0, 0, 0, 0, 0, 0, 0, 0, 0, 0, 0, 0, 0, 0, 0, 0, 0, 1159, 0, 0, 0, 0, 0,
           0, 0, 0,
           0, 0, 0, 0, 0, 0, 0, 0, 0, 0, 0, 0, 0, 0, 0, 0, 0, 0, 0, 0, 0, 0, 0, 0, 0, 0, 0, 0, 0, 0, 0, 0, 0,
           0, 0,
           0, 0, 0, 0, 0, 0, 0, 0, 0, 0, 0, 0, 0, 0, 0, 0, 0, 0, 0, 0, 0, 0, 0, 0, 0, 0, 0, 0, 0, 0, 0, 0, 0,
           0, 0,
           0, 0, 0, 0, 0, 0, 0, 0, 0, 0, 0, 0, 0, 0, 1803, 1804, 1805, 1806, 1807, 0, 0, 0, 0, 0, 0, 0, 0, 0,
           0, 0, 0, 0, 0, 0, 0,
           0, 0, 0, 0, 0, 0, 0, 0, 0, 0, 0, 0, 0, 0, 0, 0, 0, 0, 0, 0, 0, 0, 0, 0, 0, 0, 0, 0, 0, 0, 0, 0, 0,
           0, 0,
           0, 0, 0, 0, 0, 0, 0, 0, 0, 0, 0, 0, 0, 1159, 0, 0, 0, 0, 0, 0, 1159, 0, 0, 0, 0, 0, 0, 0, 0, 0, 0,
           0, 0, 0, 0,
           0, 0, 0, 0, 0, 0, 0, 0, 0, 0, 0, 0, 0, 0, 0, 0, 0, 0, 0, 0, 0, 0, 0, 0, 0, 0, 0, 0, 0, 0, 0, 0, 0,
           0, 0,
           0, 0, 0, 0, 0, 0, 0, 0, 0, 0, 0, 0, 0, 0, 0, 0, 0, 0, 0, 0, 0, 0, 0, 0, 0, 0, 0, 0, 0, 0, 0, 0, 0,
           0, 0,
           0, 0, 0, 0, 0, 0, 0, 0, 0, 0, 1537, 1538, 1539, 1540, 1537, 1538, 1539, 1540, 0, 0, 0, 0, 1798,
           1799, 1800, 1801, 1802, 0, 0, 0, 0, 0, 0, 0, 0,
           0, 0, 0, 0, 0, 0, 0, 0, 0, 0, 0, 0, 0, 0, 0, 0, 0, 0, 0, 0, 0, 0, 0, 0, 0, 0, 0, 0, 0, 0, 0, 0, 0,
           0, 0,
           0, 0, 0, 0, 0, 0, 0, 0, 0, 0, 0, 0, 0, 0, 0, 0, 0, 0, 0, 0, 0, 0, 0, 0, 0, 0, 0, 0, 0, 0, 0, 0, 0,
           0, 0,
           0, 0, 0, 0, 0, 0, 0, 0, 0, 0, 0, 0, 0, 0, 0, 0, 0, 0, 0, 0, 0, 0, 0, 0, 0, 0, 0, 0, 0, 0, 0, 0, 0,
           0, 0,
           0, 0, 0, 0, 0, 0, 0, 0, 0, 0, 0, 0, 0, 0, 0, 0, 0, 0, 0, 0, 0, 0, 0, 0, 0, 0, 0, 0, 0, 0, 0, 0, 0,
           0, 0,
           0, 0, 0, 0, 0, 0, 0, 0, 0, 0, 0, 0, 0, 0, 0, 0, 0, 0, 0, 0, 0, 0, 0, 0, 0, 0, 0, 0, 0, 0, 0, 0, 0,
           0, 0,
           0, 0, 0, 0, 0, 0, 0, 0, 0, 0, 0, 0, 0, 0, 0, 0, 0, 0, 0, 0, 0, 0, 0, 0, 0, 0, 0, 0, 0, 0, 0, 0, 0,
           0, 0,
           0, 0, 0, 0, 0, 0, 0, 0, 0, 0, 0, 0, 0, 0, 0, 0, 0, 0, 0, 0, 0, 0, 0, 0, 0, 0, 0, 0, 0, 0, 0, 0, 0,
           0, 0,
           0, 0, 0, 0, 0, 0, 0, 0, 0, 0, 0, 0, 0, 0, 0, 0, 0, 0, 0, 0, 0, 0, 0, 0, 0, 0, 0, 0, 0, 0, 0, 0, 0,
           0, 0,
           0, 0, 0, 0, 0, 0, 0, 0, 0, 0, 0, 0, 0, 0, 0, 0, 0, 0, 0, 0, 0, 0, 0, 0, 0, 0, 0, 0, 0, 0, 0, 0, 0,
           0, 0,
           0, 0, 0, 0, 0, 0, 0, 0, 0, 0, 0, 0, 0, 0, 0, 0, 0, 0, 0, 0, 0, 0, 0, 0, 0, 0, 0, 0, 0, 0, 0, 0, 0,
           0, 0,
           0, 0, 0, 0, 0, 0, 0, 0, 0, 0, 0, 0, 0, 0, 0, 0, 0, 0, 0, 0, 0, 0, 0, 0, 0, 0, 0, 0, 0, 0, 0, 0, 0,
           0, 0,
           0, 0, 0, 0, 0, 0, 0, 0, 0, 0, 0, 0, 0, 0, 0, 0, 0, 0, 0, 0, 0, 0, 0, 0, 0, 0, 0, 0, 0, 0, 0, 0, 0,
           0, 0,
           0, 0, 0, 0, 0, 0, 0, 0, 0, 0, 0, 0, 0, 0, 0, 0, 0, 0, 0, 0, 0, 0, 0, 0, 0, 0, 0, 0, 0, 0, 0, 0, 0,
           0, 0 ]
     ],
     "size" : [ 35, 35 ],
     "indoor" : false,
     "music" : "Ms",
     "events" : [
         {
             "type" : "TP",
             "textures" : "alpha",
             "trigger" : 3,
             "position" : [ 15, 12 ],
             "tp" : {
                 "position" : [ 10, 17 ],
                 "map" : "OpCenter",
                 "side" : 1
             },
             "side" : 3
         }
     ]
 }