{
     "id" : "Player's home",
     "tileset" : "alpha",
     "layers" : [
         [ 910, 910, 910, 910, 910, 910, 910, 910, 910, 910, 910, 220, 910, 910, 910, 910,
           905, 905, 905, 905, 905, 905, 905, 905, 905, 905, 911, 220, 905, 905, 905, 905,
           905, 905, 905, 905, 905, 905, 905, 905, 905, 905, 905, 220, 905, 905, 905, 905,
           905, 905, 905, 905, 905, 905, 905, 905, 905, 905, 905, 220, 905, 905, 905, 905,
           905, 905, 905, 905, 905, 905, 905, 905, 905, 905, 905, 220, 905, 905, 905, 905,
           220, 220, 220, 220, 220, 220, 220, 905, 905, 220, 220, 220, 905, 905, 905, 905,
           905, 905, 905, 905, 905, 905, 905, 905, 905, 905, 910, 910, 905, 905, 905, 905,
           905, 905, 905, 905, 905, 905, 905, 905, 905, 905, 905, 905, 905, 905, 905, 905,
           905, 2444, 2445, 2446, 905, 905, 905, 905, 905, 905, 905, 905, 905, 905, 905, 905,
           905, 2508, 2509, 2510, 905, 905, 905, 905, 905, 905, 905, 905, 905, 905, 905, 905,
           905, 905, 905, 905, 905, 905, 905, 905, 905, 905, 905, 905, 905, 905, 905, 905,
           905, 905, 905, 905, 905, 905, 905, 905, 905, 905, 905, 905, 905, 905, 905, 905,
           905, 905, 905, 905, 905, 905, 905, 905, 905, 905, 905, 905, 905, 905, 905, 905,
           905, 905, 905, 905, 905, 905, 905, 905, 905, 905, 905, 905, 905, 905, 905, 905,
           905, 905, 905, 905, 905, 905, 905, 905, 905, 905, 905, 905, 905, 905, 905, 905,
           905, 905, 905, 905, 905, 905, 905, 905, 905, 905, 905, 905, 905, 905, 905, 905 ],
         [ 0, 0, 1281, 1282, 0, 904, 904, 0, 0, 0, 0, 0, 0, 2308, 0, 0,
           1089, 914, 1345, 1346, 911, 911, 911, 911, 911, 911, 2054, 1747, 911, 911, 911, 911,
           0, 0, 0, 0, 0, 0, 0, 0, 0, 0, 0, 1747, 0, 0, 0, 2311,
           0, 1090, 1091, 1092, 0, 0, 0, 0, 0, 0, 0, 1747, 0, 0, 0, 0,
           0, 0, 0, 0, 0, 0, 0, 0, 0, 0, 0, 1747, 0, 0, 0, 0,
           0, 0, 0, 0, 0, 0, 0, 0, 0, 0, 0, 1747, 0, 0, 0, 0,
           910, 910, 910, 910, 910, 910, 910, 0, 0, 910, 2305, 2306, 0, 0, 0, 0,
           911, 911, 911, 911, 911, 911, 911, 0, 0, 911, 2369, 2370, 0, 0, 0, 0,
           0, 1230, 1231, 1232, 0, 0, 0, 0, 0, 0, 0, 0, 0, 0, 0, 0,
           0, 0, 0, 0, 0, 0, 0, 0, 0, 0, 0, 0, 0, 0, 0, 0,
           0, 1103, 1104, 1105, 0, 0, 0, 0, 0, 0, 0, 0, 0, 0, 0, 0,
           0, 0, 0, 0, 0, 0, 0, 0, 0, 0, 2119, 2120, 2121, 2307, 0, 0,
           0, 0, 0, 0, 0, 0, 0, 0, 0, 2307, 2183, 2184, 2185, 0, 0, 0,
           0, 0, 0, 0, 0, 0, 0, 0, 0, 0, 2247, 2248, 2249, 2307, 0, 0,
           0, 0, 0, 0, 0, 0, 0, 0, 0, 0, 0, 0, 0, 0, 0, 0,
           1492, 0, 0, 0, 0, 0, 2511, 2512, 2513, 0, 0, 0, 0, 0, 0, 1492 ],
         [ 1025, 850, 0, 0, 0, 0, 0, 0, 0, 0, 0, 220, 0, 0, 0, 0,
           0, 0, 0, 0, 0, 0, 0, 0, 0, 0, 0, 0, 0, 0, 0, 0,
           0, 1026, 1027, 1028, 0, 0, 0, 0, 0, 0, 0, 0, 0, 0, 0, 0,
           0, 0, 0, 0, 0, 0, 0, 0, 0, 0, 0, 220, 0, 0, 0, 0,
           0, 0, 0, 0, 0, 0, 0, 0, 0, 0, 0, 220, 0, 0, 0, 0,
           220, 220, 220, 220, 220, 220, 220, 0, 0, 220, 220, 220, 0, 0, 0, 0,
           0, 0, 0, 0, 0, 0, 0, 0, 0, 0, 0, 0, 0, 0, 0, 0,
           0, 1166, 1167, 1168, 0, 0, 0, 0, 0, 0, 0, 0, 0, 0, 0, 0,
           0, 0, 0, 0, 0, 0, 0, 0, 0, 0, 0, 0, 0, 0, 0, 0,
           0, 1039, 0, 1041, 0, 0, 0, 0, 0, 0, 0, 0, 0, 0, 0, 0,
           1425, 0, 0, 0, 0, 0, 0, 0, 0, 0, 0, 0, 0, 0, 0, 0,
           1489, 0, 0, 0, 0, 0, 0, 0, 0, 0, 0, 0, 0, 0, 0, 0,
           0, 0, 0, 0, 0, 0, 0, 0, 0, 0, 0, 2246, 0, 0, 0, 0,
           0, 0, 0, 0, 0, 0, 0, 0, 0, 0, 0, 0, 0, 0, 0, 0,
           1428, 0, 0, 0, 0, 0, 0, 0, 0, 0, 0, 0, 0, 0, 0, 1428,
           0, 0, 0, 0, 0, 0, 0, 0, 0, 0, 0, 0, 0, 0, 0, 0 ]
     ],
     "size" : [ 16, 16 ],
     "indoor" : true,
     "music" : "Fauxbourg",
     "events" : [
         {
             "type" : "TP",
             "textures" : "alpha",
             "trigger" : 1,
             "position" : [ 7, 15 ],
             "tp" : {
                 "position" : [ 27, 17 ],
                 "map" : "Fauxbourg Euvi",
                 "side" : 0
             },
             "side" : 2
         },
         {
             "type" : "TP",
             "textures" : "alpha",
             "trigger" : 1,
             "position" : [ 15, 2 ],
             "tp" : {
                 "position" : [ 8, 7 ],
                 "map" : "Player's room",
                 "side" : 2
             },
             "side" : 32
         },
         {
             "type" : "TP",
             "textures" : "alpha",
             "trigger" : 1,
             "position" : [ 0, 11 ],
             "tp" : {
                 "position" : [ 5, 3 ],
                 "map" : "Mom's room",
                 "side" : 2
             },
             "side" : 16
         },
         {
             "type" : "Dialog",
             "textures" : "alpha",
             "position" : [ 3, 8 ],
             "dialog" : ["playerhome.tv"],
             "side" : 1
         },
         {
             "type" : "Dialog",
             "textures" : "alpha",
             "position" : [ 1, 1 ],
             "dialog" : ["playerhome.fridge"],
             "side" : 1
         },
         {
             "type" : "Dialog",
             "textures" : "alpha",
             "position" : [ 10, 1 ],
             "dialog" : ["trash"],
             "side" : 1
         },
         {
             "type" : "Dialog",
             "textures" : "alpha",
             "position" : [ 2, 8 ],
             "dialog" : ["playerhome.tv"],
             "side" : 1
         },
         {
             "type" : "TalkingCharacter",
             "textures" : "playermom",
             "position" : [ 9, 9 ],
             "dialog" : ["playermom.dialog"],
             "facing" : 0,
             "passable" : false
         }
     ]
 }