{
     "id" : "player_room",
     "tileset" : "alpha",
     "layers" : [
         [ 0, 0, 0, 793, 794, 795, 0, 0, 0,
           854, 855, 856, 857, 858, 859, 860, 861, 862,
           917, 917, 917, 917, 917, 917, 917, 917, 917,
           266, 266, 266, 266, 266, 266, 266, 266, 266,
           266, 266, 266, 266, 266, 266, 266, 266, 266,
           266, 266, 266, 2444, 2445, 266, 266, 266, 266,
           266, 266, 266, 266, 2509, 266, 266, 266, 266,
           266, 266, 266, 266, 266, 266, 266, 266, 266 ],
         [ 0, 0, 0, 0, 0, 0, 0, 0, 0,
           0, 0, 0, 0, 0, 0, 0, 0, 0,
           0, 1745, 1746, 0, 1025, 2305, 2306, 0, 0,
           981, 1809, 1810, 981, 1089, 2369, 2370, 981, 981,
           0, 982, 0, 0, 0, 0, 0, 0, 0,
           0, 0, 0, 1042, 980, 2446, 0, 0, 0,
           0, 0, 0, 2508, 1044, 2510, 0, 0, 0,
           1043, 0, 0, 0, 0, 0, 0, 0, 2312 ],
         [ 0, 0, 0, 0, 0, 0, 0, 0, 0,
           0, 0, 0, 0, 0, 0, 0, 0, 0,
           0, 0, 0, 0, 0, 0, 0, 0, 0,
           0, 0, 0, 0, 0, 0, 0, 0, 0,
           0, 0, 0, 978, 0, 0, 0, 0, 0,
           0, 0, 0, 0, 851, 0, 0, 0, 0,
           979, 0, 0, 0, 0, 0, 0, 0, 0,
           0, 0, 0, 0, 0, 0, 0, 0, 0 ]
     ],
     "size" : [ 9, 8 ],
     "indoor" : true,
     "music" : "Fauxbourg",
     "events" : [
         {
             "type" : "TP",
             "textures" : "alpha",
             "trigger" : 1,
             "position" : [ 8, 7 ],
             "tp" : {
                 "position" : [ 15, 2 ],
                 "map" : "player_home",
                 "side" : 1
             },
             "side" : 32
         },
         {
             "type" : "Dialog",
             "textures" : "alpha",
             "position" : [ 3, 5 ],
             "dialog" : ["clock"],
             "side" : 1
         },
         {
             "type" : "Dialog",
             "textures" : "alpha",
             "position" : [ 1, 3 ],
             "dialog" : ["pcRunLinux"],
             "side" : 1
         }
     ]
 }