{
     "id" : "Rival's house",
     "tileset" : "alpha",
     "layers" : [
         [ 910, 910, 910, 910, 910, 910, 910, 910, 910, 910, 910, 0, 910, 910, 910, 910,
           905, 905, 905, 905, 905, 905, 905, 905, 905, 905, 911, 1747, 905, 905, 905, 905,
           905, 905, 905, 905, 905, 905, 905, 905, 905, 905, 905, 1747, 905, 905, 905, 905,
           905, 905, 905, 905, 905, 905, 905, 905, 905, 905, 905, 1747, 905, 905, 905, 905,
           905, 905, 905, 905, 905, 905, 905, 905, 905, 905, 905, 1747, 905, 905, 905, 905,
           905, 905, 905, 905, 905, 905, 905, 905, 905, 905, 905, 1747, 905, 905, 905, 905,
           905, 905, 905, 905, 905, 905, 905, 905, 905, 905, 910, 910, 905, 905, 905, 905,
           905, 905, 905, 905, 905, 905, 905, 905, 905, 905, 905, 905, 905, 905, 905, 905,
           905, 2444, 2445, 2446, 905, 905, 905, 905, 905, 905, 905, 905, 905, 905, 905, 905,
           905, 2508, 2509, 2510, 905, 905, 905, 905, 905, 905, 905, 905, 905, 905, 905, 905,
           905, 905, 905, 905, 905, 905, 905, 905, 905, 905, 905, 905, 905, 905, 905, 905,
           905, 905, 905, 905, 905, 905, 905, 905, 905, 905, 905, 905, 905, 905, 905, 905,
           905, 905, 905, 905, 905, 905, 905, 905, 905, 905, 905, 905, 905, 905, 905, 905,
           905, 905, 905, 905, 905, 905, 905, 905, 905, 905, 905, 905, 905, 905, 905, 905,
           905, 905, 905, 905, 905, 905, 905, 905, 905, 905, 905, 905, 905, 905, 905, 905,
           905, 905, 905, 905, 905, 905, 905, 905, 905, 905, 905, 905, 905, 905, 905, 905 ],
         [ 0, 0, 1034, 0, 0, 0, 904, 0, 0, 0, 0, 0, 0, 2308, 0, 0,
           1089, 914, 1098, 911, 911, 911, 911, 911, 911, 911, 2054, 220, 1089, 911, 911, 911,
           0, 0, 0, 0, 0, 0, 0, 0, 0, 0, 0, 0, 0, 0, 0, 0,
           0, 1090, 1091, 1092, 0, 0, 0, 0, 0, 0, 0, 0, 0, 1042, 980, 0,
           0, 0, 0, 0, 0, 0, 0, 0, 0, 0, 0, 0, 0, 0, 1044, 0,
           0, 0, 0, 0, 0, 0, 0, 0, 0, 0, 0, 0, 0, 0, 0, 0,
           910, 910, 910, 910, 910, 910, 910, 0, 0, 910, 2305, 2306, 0, 0, 0, 0,
           911, 911, 911, 911, 911, 911, 911, 0, 0, 911, 2369, 2370, 0, 0, 0, 0,
           0, 1230, 1231, 1232, 0, 0, 0, 0, 0, 0, 0, 0, 0, 0, 0, 0,
           0, 0, 0, 0, 0, 0, 0, 0, 0, 0, 0, 0, 0, 0, 0, 0,
           0, 1103, 1104, 1105, 0, 0, 0, 0, 0, 0, 0, 0, 0, 0, 0, 0,
           0, 0, 0, 0, 0, 0, 0, 0, 0, 0, 2119, 2120, 2121, 0, 0, 0,
           0, 0, 0, 0, 0, 0, 0, 0, 0, 2307, 2183, 2184, 2185, 0, 0, 0,
           0, 0, 0, 0, 0, 0, 0, 0, 0, 0, 2247, 2248, 2249, 2307, 0, 0,
           0, 0, 0, 0, 0, 0, 0, 0, 0, 0, 0, 0, 0, 0, 0, 0,
           1493, 0, 0, 0, 0, 0, 0, 2511, 2512, 2513, 0, 0, 0, 0, 0, 1493 ],
         [ 1025, 850, 0, 0, 0, 0, 0, 0, 0, 0, 0, 220, 1025, 0, 0, 0,
           0, 0, 0, 0, 0, 0, 0, 0, 0, 0, 0, 0, 0, 0, 0, 0,
           0, 1026, 1027, 1028, 0, 0, 0, 0, 0, 0, 0, 0, 0, 978, 0, 0,
           0, 0, 0, 0, 0, 0, 0, 0, 0, 0, 0, 220, 0, 0, 0, 0,
           0, 0, 0, 0, 0, 0, 0, 0, 0, 0, 0, 220, 0, 0, 0, 0,
           220, 220, 220, 220, 220, 220, 220, 0, 0, 220, 220, 220, 0, 0, 0, 0,
           0, 0, 0, 0, 0, 0, 0, 0, 0, 0, 0, 0, 0, 0, 0, 0,
           0, 1166, 1167, 1168, 0, 0, 0, 0, 0, 0, 0, 0, 0, 0, 0, 0,
           0, 0, 0, 0, 0, 0, 0, 0, 0, 0, 0, 0, 0, 0, 0, 0,
           0, 1039, 0, 1041, 0, 0, 0, 0, 0, 0, 0, 0, 0, 0, 0, 0,
           0, 0, 0, 0, 0, 0, 0, 0, 0, 0, 0, 0, 0, 0, 0, 0,
           0, 0, 0, 0, 0, 0, 0, 0, 0, 0, 0, 0, 0, 0, 0, 0,
           0, 0, 0, 0, 0, 0, 0, 0, 0, 0, 0, 2246, 0, 0, 0, 0,
           0, 0, 0, 0, 0, 0, 0, 0, 0, 0, 0, 0, 0, 0, 0, 0,
           1429, 0, 0, 0, 0, 0, 0, 0, 0, 0, 0, 0, 0, 0, 0, 1429,
           0, 0, 0, 0, 0, 0, 0, 0, 0, 0, 0, 0, 0, 0, 0, 0 ]
     ],
     "size" : [ 16, 16 ],
     "indoor" : true,
     "music" : "Fauxbourg",
     "events" : [
         {
             "type" : "TP",
             "textures" : "alpha",
             "trigger" : 3,
             "position" : [ 8, 15 ],
             "tp" : {
                 "position" : [ 35, 17 ],
                 "map" : "Fauxbourg Euvi",
                 "side" : 0
             },
             "side" : 2
         }
     ]
 }